w w w w w w w w w w w w
w s s s s s s s s s s w
w s s s s s s s s s s w
w s s s s s w s s s s w
w s s s s s s s s s s w
w s s s s w w w w s s w
w s s s s s s w s s s w
w s s s s s s s s s s w
w w s s s s s s s s s s w w
w s s s s w s s s s s s w w
w s s s s s s s s s s w
w w w w w w w w w w w w s
w